1111111111111111111111111111111111111111111
1111111111111111555111111111111111111111111
1111111111111155030511111111111111111111111
1111111111111150000511111111111111111111111
1100000100011150000511111111111111111111111
1100000000011150000511111111111111111111111
1100400000011100000000011111111111111111111
1100000600000000000000000011111111111111111
1100006160000000000000000011111111111111111
1100000100000000011001100011111111111111111
1100000100000000010000100000000001111111111
1110061160000000010000100000000000111111111
1100006600000000000000000000000000000111111
1100000000000000000000000000000000000111111
1100070700000000011100111110000000000000111
1100711170000000011111111100000000000000111
1100711170000000011111111100000007000000111
1100011100000000011111111100011111000070111
1100011100000000011111111000111111100711111
1100011108000000111111111000111111100011111
1100011111800000110001110001111111100011111
1100011111000000110001110001111111100011111
1100011111880000110000000011111111100011111
1100811111118001110000000011111111100011111
1100011111110001100000000111111111100011111
1100011111110001100000000111111111104011111
1100011111110000000000011111111111100011111
1100011111110000000000011111111111100011111
1000011111110000000000000011111111100011111
1000011111118000000000000000011111100011111
1000811000080000000000000000000011100011111
1000081800000080000000000000000000170011111
1000081180000818000001110000000000700711111
1000008118000811800001111110000000000070011
1110000811800081180001111111110000000000011
1000000081180008118000011111111100000000011
1000000008118040810000000011111111111100011
1111100000811808118000000000011111111111111
1111100000081808180000000000001100011111111
1111100000008000800060006000000000011111111
1111100000000000000611111600000000011111111
1111111000000000000611111600000000000000111
1111111100000070070060006000000000000000011
1111111110000711110070000000000000006600011
1111111111000070011110070000000000061160011
1111111111100000070011110007000000001000011
1111111111110000000070011111700000001000011
1111111111110010000000070007000000061600011
1111111111111111110000000000000110006000011
1111111111111111111110000000000110000000001
1111111111111111111111111111000110000000001
1111111111111111111111111111111111110000001
1111111111111111111111111111111111110000001
1111111111111111111111111111111111110040001
1111111111111111111111111111111111110000001
1111111111111111111111111111111111110000001
1111111111111111111111111111111111111111111
