1111111111111111111111111111111111111111111
1111111111111111555111111111111111111111111
1111111111111155030511111111111111111111111
1111111111111150000511111111100000000001111
1100000100011150000511111111100000000001111
1100000000011150000511111111100000000001111
1100400000011100000000011111100000000001111
1100000600000000000000000011111000000111111
1100006160000000000000000011111000000111111
1100000100000000000010000011111000000111111
1100000100000000000011000000000000000111111
1110061160000000000001000000000000000111111
1100006600000000000000000000000000000111111
1100000000000000000000000000000000000111111
1100070700000000001100000110000000011111111
1100711170000000011111000111111111111111111
1100711170000000111111000111111111111111111
1100070700000011111111000000111111111111111
1100000000001111111100000000001111111111111
1100000008011111111000000000000000111111111
1100000000111111110000000000000000011111111
1100000001111111110000000000000000001111111
1100080011111111110000000000000000000111111
1100811111111111110000011111100000001111111
1100011111111111100000011111100000001111111
1100011111111111100000011111110000011111111
1100011111110000000000011111110000011111111
1100011111110000000000011111100000001111111
1000011111110000000000000011100000001111111
1000011111118000000000000000000000000111111
1000811000011000000000000000000000000011111
1000081800001110000000000000000000400001111
1000081180000111000000000011100000000011111
1000008118000011100001111111111000000011111
1000000811800001110001111111111000000011111
1000000081180000000000011111111000000111111
1000000008118040000000000011111000000111111
1111100000811808118000000000011100001111111
1111100000081111180000000000001100011111111
1111100000008000800060006000000000011111111
1111100000000000000611111600000000011111111
1111111000000000000611111600000000000000111
1111111100000070070060006000000000000000011
1111111110000711110070000000000000006600011
1111111111000070011110070000000000061160011
1111111111100000070011110007000000001100011
1111111111100000000070011111700000001100011
1111111111000010000000070007000000061160011
1111111110000011110000000000000110006600011
1111111100000011111110000000000111000000001
1111111100000011111111100000111111100000001
1111111110000000000000000001111111111111111
1111111111000040000000000011111111111111111
1111111111100000000000011111111111111111111
1111111111111111111111111111111111111111111
1111111111111111111111111111111111111111111
1111111111111111111111111111111111111111111
