1111111111111111111111111111111111111111111
1111111111111111000111111111111111111111111
1111111111111100030011111111111111111111111
1111111111111100000011111111111111111111111
1100000100011100000011111111111111111111111
1100000000011100000011111111111111111111111
1100400000011100000000011111111111111111111
1100000000000000000000000011111111111111111
1100000100000000000000000011111111111111111
1100000100000000000010000011111111111111111
1100000100000000000011000000000000111111111
1110001100000000000001000000000000111111111
1100000000000000000000000000000000000111111
1100000000000000000000000000000000000111111
1100000000000000001100000110000000000000111
1100011100000000011111000111100000000000111
1100011100000000011111111111100000000000111
1100000000000000011111111111111111000000111
1100000000000000011111111111111111100011111
1100000000000000111111111111111111100011111
1100000001000000110001111111111111100011111
1100000001000000110001111111111111100011111
1100000001000000110000011111111111100011111
1100011111110001110000011111111111100011111
1100011111110001100000011111111111100011111
1100011111110001100000011111111111104011111
1100011111110000000000011111111111100011111
1100011111110000000000011111111111100011111
1000011111110000000000000011111111100011111
1000011111110000000000000000010011100011111
1000011000000000000000000000000011100011111
1000001000000000000000000000000000100011111
1000001100000010000001110000000000000011111
1000000110000011000001111110000000000000011
1000000011000001100001111111110000000000011
1000000001100000110000011111111100000000011
1000000000110040010000000011111111111100011
1111100000011000110000000000011111111111111
1111100000001000100000000000001100011111111
1111100000000000000000000000000000011111111
1111100000000000000011111000000000011111111
1111111000000000000011111000000000000000111
1111111100000000000000000000000000000000011
1111111110000011110000000000000000000000011
1111111111000000011110000000000000001100011
1111111111100000000011110000000000001100011
1111111111110000000000011111000000001100011
1111111111110010000000000000000000001100011
1111111111111111110000000000000110000000011
1111111111111111111110000000000110000000001
1111111111111111111111111111000110000000001
1111111111111111111111111111111111110000001
1111111111111111111111111111111111110000001
1111111111111111111111111111111111110040001
1111111111111111111111111111111111110000001
1111111111111111111111111111111111110000001
1111111111111111111111111111111111111111111
