1111111111111111111111111111111111111111111
1111111111111111555111111111111111111111111
1111111111111155030511111111111111111111111
1111111111111150000511111111111111111111111
1100000100011150000511111111111111111111111
1100000000011150000511111111111111111111111
1100400000011100000000011111111111111111111
1100006600000000000000000011111111111111111
1100061160000000000000000011111111111111111
1100001100000000000010000011111111111111111
1100001100000000000011000000000001111111111
1110061160000000000001000000000000111111111
1100006600000000000000000000000000000111111
1100000000000000000000000000000000000111111
1100070700000000001100000110000000000000111
1100711170000000011111000100000000000000111
1100711170000000011111111100000007000000111
1100070700000000011111111100011111000070111
1100000000000001111111111000111111100711111
1100000008000001111111111000111111100011111
1100000081800011110001110001111111100011111
1100000001000111110001110001111111100011111
1100080081881111110000000011111111100011111
1100811111111111110000000011111111100011111
1100011111111111100000000111111111100011111
1100011111111111100000000111111111104011111
1100011111111100000000011111111111100011111
1100011111111000000000011111111111100011111
1000011111110000000000000011111111100011111
1000011111118000000000000000011111100011111
1000811000080000000000000000000011100011111
1000081800000000000000000000000000170011111
1000081180000000000001110000000000700711111
100000811800001100000111110000000000070011
1000000811800081180000111111110000000000011
1000000081180008118000001111111100000000011
1000000008118040810000000011111111111000011
1111100008118008118000000000011111111000111
1111100000000001180000000000000111111000111
1111100000080011800060006000000000111000111
1111100000000110000611111600000000001000111
1111111000000110000611111600000000000000111
1111111100000011700060006000001000000000011
1111111110000711110070000000001100006600011
1111111111000077770070000000000100061160011
1111111111100000000711110007000000001000011
1111111111110000000070011111700000001000011
1111111111110010000000070007000000061060011
1111111111111111110000000000000110006000011
1111111111111111111110000000000110000000001
1111111111111111111111111111000110000000001
1111111111111111111111111111111111110000001
1111111111111111111111111111111111110000001
1111111111111111111111111111111111110040001
1111111111111111111111111111111111110000001
1111111111111111111111111111111111110000001
1111111111111111111111111111111111111111111
