1111111111111111111111111111111111111111111
1111111111111111555111111111111111111111111
1111111111111155030511111111111111111111111
1111111111111150000511111111111111111111111
1100000100011150000511111111111111111111111
1100000000011150000511111111111111111111111
1100400000011100000000011111111111111111111
1100000600000000000000000011111111111111111
1100006160000000000000000011111111111111111
1100000100000000000010000011111111111111111
1100006100000000000011000000000001111111111
1110061160000000000001000000000000111111111
1100006600000000000000000000000000000111111
1100000000000000000000000000000000000111111
1100070700000000001100000110000000000000111
1100711170000000011111000111100000000000111
1100711170000000011111111111100000000000111
1100070700000000011111111111111111000000111
1100000000000000011111111111111111100011111
1100000008000000111111111111111111100011111
1100000081800000110001111111111111100011111
1100000001000000110001111111111111100011111
1100080081880000110000011111111111100011111
1100811111118001110000011111111111100011111
1100011111110001100000011111111111100011111
1100011111110001100000011111111111104011111
1100011111110000000000011111111111100011111
1100011111110000000000011111111111100011111
1000011111110000000000000011111111100011111
1000011111118000000000000000011111100011111
1000811000080000000000000000000011100011111
1000081800000080000000000000000000100011111
1000081180000818000001110000000000000011111
1000008118000811800001111110000000000000011
1000000811800081180001111111110000000000011
1000000081180008118000011111111100000000011
1000000008118040810000000011111111111100011
1111100000811808118000000000011111111111111
1111100000081808180000000000001100011111111
1111100000008000800000000000000000011111111
1111100000000000000011111000000000011111111
1111111000000000000011111000000000000000111
1111111100000000000000000000000000000000011
1111111110000011110000000000000000000000011
1111111111000000011110000000000000001100011
1111111111100000000011110000000000001100011
1111111111110000000000011111000000001100011
1111111111110010000000000000000000001100011
1111111111111111110000000000000110000000011
1111111111111111111110000000000110000000001
1111111111111111111111111111000110000000001
1111111111111111111111111111111111110000001
1111111111111111111111111111111111110000001
1111111111111111111111111111111111110040001
1111111111111111111111111111111111110000001
1111111111111111111111111111111111110000001
1111111111111111111111111111111111111111111
