1111111111111111111111
1000000000000000000001
1000000000111000000001
1000011111101111110001
1000011000000000110001
1000100000030000010001
1000100000000000010001
1001100001111111110001
1000100000000000010001
1000100000000000010001
1000100000000000010001
1000111111111000011001
1000100000000000010001
1000100000400000010001
1000110000000000110001
1000111111011111100001
1000000001110000000001
1000000000000000000001
1111111111111111111111