111111111111111111111
100000000000000000001
100000000111000000001
100011111101111110001
100011000000000110001
100010000030000010001
100010000000000010001
100110001111111110001
100010000000000010001
100010000000000010001
100010000000000010001
100011111111100011001
100010000000000010001
100010000030000010001
100011000000000110001
100011111101111110001
100000000111000000001
100000000000000000001
111111111111111111111