222222222222222222222
200000000000000000002
200000000222000000002
200022222202222220002
200022000000000220002
200020000030000020002
200020000000000020002
200220002222222220002
200020000000000020002
200020000000000020002
200020000000000020002
200022222222200022002
200020000000000020002
200020000030000020002
200022000000000220002
200022222202222220002
200000000222000000002
200000000000000000002
222222222222222222222