1111111111111111111111111111111111111111111111111111111
1000000000000000000000000000000000000000000000000000001
1000000000000000000000000000000000000000000000000000001
1000000000000000000000000000000000000000000000000000001
1000111111110001111111000111000111000111111111111110001
1000111111110001111111000111000111000111111111111110001
1000111111110001111111000111000111000111111111111110001
1000111111110001111111000000000000000111111111111110001
1000111111110001111111000000000000000111111111111110001
1000111111110001111111000000000000000111111111111110001
1000111111110001111111000111111111000111111111111110001
1000111111110001111111000111111111000111111111111110001
1000111111110001111000000111111111000111111111111110001
1000111111110000000000000000000000000000000000111110001
1000111111110000000000000000040000000000000000111110001
1000111111110000000111000000000000000000000000111110001
1000111111110001111111000111111111000111111000111110001
1000111111110001111111000111111111000111111000111110001
1000111111110001111111000111111111000111111000111110001
1000111111110001111111000111111111000111111000111110001
1000000000000000000000000000000000000000000000000000001
1000000000000000000000000000000000000000000000000000001
1030000000000000000000000000000000000000000000000000001
1000000000000000000000000000000000000000000000000000001
1000000000000000000000000000000000000000000000000000001
1000111111110001111111000111111111000111111000111111111
1000111111110001111111000111111111000111111000111111111
1000111111110001111111000111111111000111111000111111111
1000000000000000000011000111111111000111111000111111111
1000000000000000000011000111111111000111111000111111111
1000000000000000000011000111111111000111111000111111111
1000111111111111100011000111111111000111111000111111111
1000111111111111100011000111111111000111111000111111111
1000111111111111100011000111111111000111111000111111111
1000111111111111100011000111111111000111111000111111111
1000111111111111100011000111111111000111111000111111111
1000111111111111100011000111111111000111111000111111111
1000111111111111100011000111111111000111111000111111111
1000000111111111100000000111111111000000000000000000011
1000000111111111100000000111111111000000000000000000011
1000000111111111100000000111111111000000000000000000011
1000000111111111100000000111111111000000000000000000011
1000000111111111100000000111111111000000000000000000011
1000000111111111100000000111111111000000000000000000011
1000000000000000000000000000000000000000000000000000011
1000000000000000000000000000000000000000000000000000011
1000000000000000000000000000000000000000000000000000011
1111111111111111111111111111111111111111111111111111111