1111111111111111111111111111111111111111111111111111111
1000000000000000000000000000000000000000000000000000001
1000000000000000000000000000000000000000000000000000001
1000666666660007777777000606000606000777777777777770001
1006111111116071111111706111606111607111111111111117001
1000111111110001111111000111000111000111111111111110001
1000111111110001111111006111606111600111111111111110001
1000111111110001111111000606000606000111111111111110001
1000111111110001111111000000000000000111111111111110001
1000111111110001111111000800000008000111111111111110001
1000111111110001111111006111111111600111111111111110001
1000111111110001111111700111111111000111111111111110001
1000111111110071111707006111111111607111111111111110001
1000111111110007007000000800000008000900000000111110001
1000111111110000000707000000040000000000000000111110001
1000111111110007007111700600000006000700007000111110001
1000111111110071111111006111111111607111111700111110001
1000111111110001111111000111111111000111111000111110001
1000111111110001111111000111111111000111111000111110001
1006111111116071111111706111111111607111111706111116001
1500666666660007777777000666666666000777777000666660001
1500000000000000000000000000000000000000000000000000001
1530000000000000000000000000000000000000000000000000001
1500000000000000000000000000000000000000000000000000001
1500666666660007777777000666666666000777777000000000001
1006111111116071111111706111111111607111111700111111111
1000111111110001111111000111111111000111111000111111111
1006111111116071111111000111111111000111111000111111111
1000666666660007000711000111111111000111111000111111111
1000000000000000000011000111111111000111111000111111111
1000666666666666600011000111111111000111111000111111111
1006111111111111160011000111111111000111111000111111111
1000111111111111100011000111111111000111111000111111111
1000111111111111100011000111111111000111111000111111111
1000111111111111100011000111111111000111111000111111111
1000111111111111100011000111111111000111111000111111111
1000111111111111100011000111111111000111111000111111111
1006111111111111100711700111111111007111111700111111111
1000606111111111100077000111111111000777777000000000011
1000000111111111100000000111111111000000000000000000011
1000000111111111100000000111111111000000000000000000011
1000000111111111100000000111111111000000000000000000011
1000000111111111100000000111111111000000000000000000011
1000006111111111160000006111111111600000000000000000011
1000000666666666600000000666666666000000000000000000011
1000000000000000000000000000000000000000000000000000011
1000000000000000000000000000000000000000000000000000011
1111111111111111111111111111111111111111111111111111111