1111111111111111111111111111111111111111
1111111111111110000000000000111111111111
1000000010000010000000000000111111111111
1000000010000000000000000000111111111111
1000000010000000000001000000111111111111
1000600010000000000001111111111111111111
1006111110000010000001000000111111111111
1006160011111110000000000000111111111111
1000600000555510000000000000111111111111
1000000000030510000000000000111111111111
1000000000000510000001000000111111111111
1000000000000010007001000000111111111111
1000000000000717071111111111111111111111
1000000000000070007006116000000000000001
1000000000000000000000660000000000000001
1000000000000000000000000000110001100001
1000000000000000000000000000110001100001
1000000000000000000000600000000000000001
1111111110000000000006110000000000000001
1111111110000000000000610000007777770001
1000000000000000000000010000071111117001
1000000000000000000000010000071111117001
1000000000000000000000010000071111117001
1111111111111100000000010000007777770001
1111111111111100000000010000000000000001
1111111111111100000000010000000000000001
1111111111111100000000010000000000000001
1111111111111100000001111111111111111111
1111111111111100000001000000000000000001
1111111111111100000001000000000000000001
1111111111111100000001000000000000000001
1111111111111100000001000006666600000001
1111111111111100000001000061111164000001
1111111111111100000001000061111160000001
1111111111111100000001000061111160000001
1111111111111100000071700006666600000001
1111111111111100000007000000000000110001
1111111111111100000000000000000000110001
1111111111111100000000000000000000110001
1111111111111100000007000011110000110001
1111111111111100000071700011110000110001
1111111111111100000601111111111111111111
1111111111111110006111000000000000000001
1111111111111100000600000000000000000001
1111111111111100000000077700006660000001
1111111111111106000000711170061116000001
1111111111111111600000711170061116000111
1111111111111111000000711170061116000111
1111111111111111000000711170061116000111
1111111111111100000000077700006660000001
1111111111111100000000000000000000000001
1111111111111100000000000000000000000001
1111111111111111111111111111111111111111