1111111111111111111111111111111111111
1111111110000000001100000000011111111
1111111110000000001100000000011111111
1111111110000000001100000000011111111
1111111110000000001100000000011111111
1111111111110001111111100011111111111
1000000011110001111111100011111100001
1000000011110001111111100011111100001
1000000011110001111111100011111100001
1000000000000000000000000000000000001
1000000000000000000000000000000000001
1000000000000000000000000000000000001
1000000011110001111111100011111100001
1000000011110001111111100011111100001
1000000011110001111111100011111100001
1110301111110001111111100011111111111
1110001110000000001100000000011111111
1111111110000000001100000000011111111
1111111110000000001104000000011111111
1111111110000000001100000000011111111
1111111111111111111111111111111111111