11111111111111111111111111111111111111111111111111111
11111100000100000100000100000100000100000111111111111
11111100000100000100000100400100000100000111111111111
11111100000100000100000100000100000100000111111111111
11111170000100000100000100000100000100007111111111111
11111117001110001110001110001110001110071111111111111
10000070007770007770007770007770007770007000010000001
10000000000000000000000000000000000000000000010000001
10000000000000006000600000000000000000000000010000001
10061111111111111606111111111111111111111600000000001
10001000100010001000100010001000100010001000000000111
10061606160616061606160616061606160616061600000000111
10006000600060006000600060006000600060006000011111111
10000000000000000000000000000040000000000000011111111
10007000700070007000700070007000700070007000011111111
10071707170717071707170717071707170717071700011111111
10001000100010001000100010001000100010001000011111111
10071111111111111707111111111111111111111700011111111
10001000100010001000100010001000100010000000011111111
10071707170717071707170717071707170717000000511111111
10007000700070007000700070007000700070000000511111111
10000000000000000000000000000000000000000003511111111
10000006000000000000000000000000000000000600511111111
10000061111111111111111111111111111111111160511111111
10000001110001000000111000100011111111111100011111111
10000061116001000000111000100011111111111100011111111
10000006060001000006111600100011111111111100011111111
10007000000001000000606000000011111111111100011111111
10071700000001000000000000000011111111111100011111111
10001000000001000000000000000011111111111100011111111
10001000000001000000000000000011111111111100011111111
10001000000001000000000000100011111111111100011111111
10001111111111000000000011111111111111111100011111111
10001000000001000000000010000011111111111100011111111
10001000000001110000000000000011111111111100011111111
10001000040001110000000000000011111111111100011111111
10071700000001110000000010000011111111111100011111111
10007000000001110000000010000011111111111100011111111
10000000000001110000000010000011111111111100011111111
10000007000001110007000010000011111111111100011111111
10000071111111110071111111111111111111111170011111111
10000007000000000007000000000000000000000700011111111
10000000000000000000000000000000000000000000011111111
10000000000000000000000000000000000000000000011111111
10000666000666000666666000666000666660000000011111111
10000111000111000111111000111000111110001111111111111
10000100000010000001000000010000001000000111111111111
10000100000010000001000000010000001000000111111111111
10000100000010000001000000010000001000000111111111111
10000111000010000001111000010000001000000111111111111
10000111000010000001000000010040001000000111111111111
10000111000010000001000000010000001000000111111111111
11111111111111111111000000111111111111111111111111111
11111111111111111111111111111111111111111111111111111
