11111111111111111111111111111111111111111111111111111
11111100000100000100000100000100000100000111111111111
11111100000100000100000100400100000100000111111111111
11111100000100000100000100000100000100000111111111111
11111100000100000100000100000100000100000111111111111
11111110001110001110001110001110001110001111111111111
10000000000000000000000000000000000000000000010000001
10000000000000000000000000000000000000000000010000001
10000000000000000000000000000000000000000000010000001
10001111111111111000111111111111111111111000000000001
10001000100010001000100010001000100010001000000000111
10001000100010001000100010001000100010001000000000111
10000000000000000000000000000000000000000000011111111
10000000000000000000000000000040000000000000011111111
10000000000000000000000000000000000000000000011111111
10001000100010001000100010001000100010001000011111111
10001000100010001000100010001000100010001000011111111
10001111111111111000111111111111111111111000011111111
10001000100010001000100010001000100010000000011111111
10001000100010001000100010001000100010000000011111111
10000000000000000000000000000000000000000000011111111
10000000000000000000000000000000000000000030011111111
10000000000000000000000000000000000000000000011111111
10000001111111111111111111111111111111111100011111111
10000001110001000000111000100011111111111100011111111
10000001110001000000111000100011111111111100011111111
10000000000001000000111000100011111111111100011111111
10000000000001000000000000000011111111111100011111111
10001000000001000000000000000011111111111100011111111
10001000000001000000000000000011111111111100011111111
10001000000001000000000000000011111111111100011111111
10001000000001000000000000100011111111111100011111111
10001111111111000000000011111111111111111100011111111
10001000000001000000000010000011111111111100011111111
10001000000001110000000000000011111111111100011111111
10001000040001110000000000000011111111111100011111111
10001000000001110000000010000011111111111100011111111
10000000000001110000000010010011111111111100011111111
10000000000001110000000010000011111111111100011111111
10000000000001110000000010000011111111111100011111111
10000001111111110001111111111111111111111100011111111
10000000000000000000000000000000000000000000011111111
10000000000000000000000000000000000000000000011111111
10000000000000000000000000000000000000000000011111111
10000000000000000000000000000000000000000000011111111
10000111000111000111111000111000111110001111111111111
10000100000010000001000000010000001000000111111111111
10000100000010000001000000010000001000000111111111111
10000100000010000001000000010000001000000111111111111
10000111000010000001111000010000001000000111111111111
10000111000010000001000000010040001000000111111111111
10000111000010000001000000010000001000000111111111111
11111111111111111111000000111111111111111111111111111
11111111111111111111111111111111111111111111111111111
