1111111111111111111111111111111111111111
1111111111111110000000000000111111111111
1000000010000010000000000000111111111111
1000000010000000000000000000111111111111
1000000010000000000001000000111111111111
1000000010000000000001111111111111111111
1000111110000010000001000000111111111111
1000000011111110000000000000111111111111
1000000000000010000000000000111111111111
1000000300000010000000000000111111111111
1000000000000010000001000000111111111111
1000000000000010000001000000111111111111
1000000000000010001111111111111111111111
1000000000000000000000010000000000000001
1000000000000000000000000000000000000001
1000000000000000000000000000110001100001
1000000000000000000000000000110001100001
1000000000000000000000000000000000000001
1111111110000000000000010000000000000001
1111111110000000000000010000000000000001
1000000000000000000000010000001111110001
1000000000000000000000010000001111110001
1000000000000000000000010000001111110001
1111111111111100000000010000000000000001
1111111111111100000000010000000000000001
1111111111111100000000010000000000000001
1111111111111100000000010000000000000001
1111111111111100000001111111111111111111
1111111111111100000001000000000000000001
1111111111111100000001000000000000000001
1111111111111100000001000000000000000001
1111111111111100000001000000000000000001
1111111111111100000001000001111104000001
1111111111111100000001000001111100000001
1111111111111100000001000001111100000001
1111111111111100000001000000000000000001
1111111111111100000000000000000000110001
1111111111111100000000000000000000110001
1111111111111100000000000000000000110001
1111111111111100000000000011110000110001
1111111111111100000001000011110000110001
1111111111111100000001111111111111111111
1111111111111110000111000000000000000001
1111111111111100000000000000000000000001
1111111111111100000000000000000000000001
1111111111111100000000011100001110000001
1111111111111111000000011100001110000111
1111111111111111000000011100001110000111
1111111111111111000000011100001110000111
1111111111111100000000000000000000000001
1111111111111100000000000000000000000001
1111111111111100000000000000000000000001
1111111111111111111111111111111111111111